#################################
#SSSSSSSS|........#.............#
#........#........#.............#
#####|####RRRRRRRR#.............#
#.s......#####|####.............#
#........#......................#
#...h....#......................#
#........#....SRSSR.............#
#........#....SRSDR.............#
#...p....#......................#
#........#...............@......#
#........#......................#
#################################