#################################
#.S......|........#.............#
#........#........#.............#
#####|####........#.............#
#........#####|####.............#
#........#......................#
#........#......................#
#........#.....U................#
#........#......................#
#........#......................#
#........#...............@......#
#........#......................#
#################################