#################################
#.S......|........#.............#
#........#........#.............#
#####|####........#.............#
#......S.#####|####.............#
#........#......................#
#........#......................#
#........#......................#
#........#..........R...........#
#........#......................#
#........#......................#
#...@....#......................#
#################################