#################################
#........|........#.............#
#........#........#.............#
#####|####........#.............#
#........#####|####.............#
#...P....#......................#
#################################