#################################
#SSSSSSSS|........#.............#
#........#........#.............#
#####|####RRRRRRRR#.............#
#........#####|####.............#
#........#......................#
#........#......................#
#........#....SRSSR.............#
#........#....SRSDR.............#
#........#......................#
#........#...............@......#
#........#......................#
#################################