#################################
#.S......|.#...................U#
#........#.#....................#
#........#.#....................#
#........#|#....................#
#........#.#....................#
#........#.#....................#
#........#.#....................#
#........#.#....................#
#........#.#....................#
#........#.#....................#
#.@......#.|....................#
#################################